1111111111111111111111111111111111
1E00000C00000000000000000000000001
1010010100100000101001000C00010101
101C010010101010001001000000010101
10P0C000000000000000000000C0000001
1111111111111111111111111111111111