11111
1E001
10001
100C1
11111
